10
1111111111
1111111111
1111111111
0011111111
0000011111
0000000000
0000000000
0000000000
0000000000
0000000000