10
0000000000
0000000011
0000111111
0001111111
0111111111
0111111111
1111111111
1111111111
1111111111
1111111111