10
1111111111
1111111111
1111111111
1111000000
1110000000
1110000000
1111000000
1111111000
1111111111
1111111111