10
1111111111
1111111111
1111111111
1111111110
1111111100
1111111100
0011111000
0001111000
0000111000
0000111000