10
1111111111
1111111111
1111111111
1111111111
1111111111
0111111111
0000111111
0000001111
0000000000
0000000000