10
1111111000
1111110000
1111100000
1111000000
1110000011
0000000111
0000001111
0000011111
0000111111
0000111111