10
1111111111
1111111111
1111111111
1111111111
1111111111
1111111100
1111111000
1111100000
1111000000
1110000000